{
	"maps":
	[
		{
			"lines" : 10,
			"columns" : 6,
			"tiles" : [
				1,0,0,0,0,0,
				0,1,0,0,0,0,
				0,0,1,0,0,0,
				0,0,0,1,0,0,
				0,0,0,0,1,0,
				0,0,0,0,0,0,
				0,0,0,0,0,0,
				0,0,0,0,0,0,
				0,0,0,0,0,0,
				0,0,0,0,0,0
			]
		},
		{
			"lines" : 10,
			"columns" : 6,
			"tiles" : [
				0,0,0,0,0,0,
				0,0,0,0,0,0,
				0,0,0,0,0,0,
				0,0,0,0,0,0,
				0,0,0,0,0,0,
				0,0,0,0,0,0,
				0,0,0,0,0,0,
				0,0,0,0,0,0,
				0,0,0,0,0,0,
				0,0,0,0,0,0
			]
		},
		{
			"lines" : 10,
			"columns" : 6,
			"tiles" : [
				0,0,0,0,0,0,
				0,0,0,0,0,0,
				0,0,0,0,0,0,
				0,0,0,0,0,0,
				0,0,0,0,0,0,
				0,0,0,0,0,0,
				0,0,0,0,0,0,
				0,0,0,0,0,0,
				0,0,0,0,0,0,
				0,0,0,0,0,0
			]
		},
		{
			"lines" : 10,
			"columns" : 6,
			"tiles" : [
				0,0,0,0,0,0,
				0,0,0,0,0,0,
				0,0,0,0,0,0,
				0,0,0,0,0,0,
				0,0,0,0,0,0,
				0,0,0,0,0,0,
				0,0,0,0,0,0,
				0,0,0,0,0,0,
				0,0,0,0,0,0,
				0,0,0,0,0,0
			]
		}
	]
}
