{
	"maps":
	[
		{
			"lines" : 7,
			"columns" : 7,
			"tiles" : [
				7,0,4,0,6,0,4,
				0,0,0,0,8,0,0,
				5,8,0,0,0,7,0,
				0,0,1,3,2,0,0,
				0,0,0,0,0,0,6,
				0,4,9,0,0,10,0,
				6,0,7,0,0,0,5
			],
			"quantities" : [
				2,1,1,1,1,1,2,
				1,1,1,1,1,1,1,
				1,1,1,1,1,1,1,
				1,1,1,1,1,1,1,
				1,1,1,1,1,1,1,
				1,1,1,1,1,1,1,
				2,1,1,1,1,1,2
			]
		},
		{
			"lines" : 7,
			"columns" : 7,
			"tiles" : [
				6,0,8,0,0,0,5,
				0,0,0,0,6,0,0,
				0,0,5,7,0,0,4,
				0,9,1,3,2,12,0,
				7,0,0,4,6,0,0,
				0,0,5,0,0,0,0,
				4,0,0,0,11,0,7
			],
			"quantities" : [
				1,1,1,1,1,1,1,
				1,1,1,1,1,1,1,
				1,1,1,1,1,1,1,
				1,1,1,1,1,1,1,
				1,1,1,1,1,1,1,
				1,1,1,1,1,1,1,
				1,1,1,1,1,1,1
			]
		},
		{
			"lines" : 7,
			"columns" : 7,
			"tiles" : [
				7,0,0,0,7,0,6,
				0,8,5,0,0,9,0,
				4,0,0,10,0,4,0,
				0,0,1,3,2,0,0,
				0,7,0,0,0,6,0,
				0,0,0,11,0,0,0,
				5,0,6,0,5,0,4
			],
			"quantities" : [
				1,1,1,1,1,1,1,
				1,1,1,1,1,1,1,
				1,1,1,1,1,1,1,
				1,1,1,1,1,1,1,
				1,1,1,1,1,1,1,
				1,1,1,1,1,1,1,
				1,1,1,1,1,1,1
			]
		},
		{
			"lines" : 7,
			"columns" : 7,
			"tiles" : [
				5,0,11,0,0,0,4,
				0,0,0,0,6,0,0,
				0,0,5,7,0,0,4,
				0,8,1,3,2,10,0,
				7,0,0,4,6,0,0,
				0,0,5,0,0,0,0,
				7,0,0,0,12,0,6
			],
			"quantities" : [
				1,1,1,1,1,1,1,
				1,1,1,1,1,1,1,
				1,1,1,1,1,1,1,
				1,1,1,1,1,1,1,
				1,1,1,1,1,1,1,
				1,1,1,1,1,1,1,
				1,1,1,1,1,1,1
			]
		}
	]
}
